11111111111111111111
10000000000000000101
10101010101010100101
10101010101010100101
10111110101010100101
100e1m00101010100101
10001010101010100101
11111010101010100101
10101010101010010001
10000010001010100101
11111110111010100101
10101010101010100101
10101010101010100101
10101010101010100101
10101010101010100101
10101010101010100101
10101010101010100101
10000000000000000101
11111111111111111111