111111111111111111
100000e10000000001
101111111111110101
101000000000000101
101111111110000101
100001000010111101
111101000010010001
10000m000010010001
100011100000010001
100010000000000000
111111111111111111

